111111111111111111111111111111
1P0000000000C10000000100000001
101111011011N10101110111111101
10000001000011010N0100000N0001
111101110111010101011111110101
1N00C1000100000101000000010C01
101111010101110101011111010101
100000N101000101C0000001110001
111110110111010111111101011101
10000000000001001000000000C001
111011111110111011101111111101
100C100000C0000000100100000001
101110111N1111111001011111N101
1000001C100000C000010000011111
1N111010001111101111N1100000E1
111111111111111111111111111111